+---+---+---+
| S         |
+---+---+   +
|           |
+   +---+   +
|   |     E |
+---+---+---+